P...#..###
#......0##
..........
.0.#.....#
..........
.....0#.D#