0.........
#######.#.
........#.
.....0..#.
P.......#D