....#..#.D
#0........
...#......
...#.....0
P.........
.....0#..#