P...#..#.#
#.......##
....#....#
#0.#.....#
.........#
D....0#0##